#########################################
#.........#.....#...#...#.............#.#
###.#####.#.#.#.#.#.#.#.#.#######.###.#.#
#...#...#.#.#.#.#.#...#.#.....#.#.#.....#
#.#####.#.###.#.#######.#####.#.#.#####.#
#.#...#.....#.#.......#.........#...#...#
#.#.#.#####.#.#######.#####.#####.#.#####
#...#...#.....#...#.......#.#...#.#.#...#
#.#####.#######.#.#######.###.#.#.#.#.#.#
#.#...#.#.....#.#...#...#...#.#.#.#...#.#
#.###.#.#.###.#.###.#.#.###.#.#.#.#####.#
#.....#.#...#...#...#.#.#.#...#.#.#...#.#
###.###.###.#####.###.#.#.#####.#.#.#.#.#
#...#.....#...#.......#.#.....#.#...#.#.#
#.###.###.###.#########.###.#.#.#######.#
#.#...#.#...#.....#...#.#...#.#...#...#.#
#.#.###.###.#####.###.#.#.#######.#.#.#.#
#.#.#.....#.....#.#...#.#.#.........#.#.#
###.#####.#####.#.#.###.#.#.#########.#.#
#...#...#...#...#.#.....#...#.....#.#.#.#
#.###.#.#.###.###.#####.#####.###.#.#.#.#
#.#...#.#.#.....#.#..@#.......#...#.#.#.#
#.#.###.#.#.#####.#.###########.###.#.#.#
#.....#.#...#.#...#...#.#.......#.....#.#
#####.#.#.###.#.#####.#.#.#######.#####.#
#...#.#.#.....#.......#.#.......#.#...#.#
#.#.#.#.###############.#######.#.#.#.#.#
#.#.#.#.#...............#.#.....#...#.#.#
#.#.###.#.###########.#.#.#.#########.#.#
#.#.....#.........#...#.#.#...#...#...#.#
#.###########.#####.###.#.###.#.###.###.#
#.#.......#...#.....#...#...#.#...#.#...#
#.#.###.#.#.###.#####.###.#.#.###.#.#.#.#
#.....#.#O#...#.#.....#...#.#...#.#...#.#
#.#####.#####.#.#.#####.#######.#.#####.#
#.#.#...#.....#.#.......#.....#.#...#...#
#.#.#.###.#####.#########.#.###.#.#.#.###
#...#...#...#.#.#...#...#.#.....#.#.#.#.#
###.###.###.#.#.#.#.#.#.#.#######.###.#.#
#.....#.......#...#...#...#.............#
#########################################