#########################################
#.........#.....#...#...#.............#.#
###.#####.#.#.#.#.#.#.#.#.#######.###.#.#
#...#...#.#.#.#.#.#...#.#.....#.#.#.....#
#.#####.#.###.#.#######.#####.#.#.#####.#
#.#...#.....#.#.......#.........#...#...#
#.#.#.#####.#.#######.#####.#####.#.#####
#...#...#.....#***#.......#.#...#.#.#...#
#.#####.#######*#*#######.###.#.#.#.#.#.#
#.#...#.#*****#*#***#***#...#.#.#.#...#.#
#.###.#.#*###*#*###*#*#*###.#.#.#.#####.#
#.....#.#***#***#***#*#*#.#...#.#.#...#.#
###.###.###*#####*###*#*#.#####.#.#.#.#.#
#...#.....#***#..*****#*#.....#.#...#.#.#
#.###.###.###*#########*###.#.#.#######.#
#.#...#.#...#*****#...#*#...#.#...#...#.#
#.#.###.###.#####*###.#*#.#######.#.#.#.#
#.#.#.....#.....#*#...#*#.#.........#.#.#
###.#####.#####.#*#.###*#.#.#########.#.#
#...#...#...#...#*#....*#...#*****#.#.#.#
#.###.#.#.###.###*#####*#####*###*#.#.#.#
#.#...#.#.#.....#*#**@#*******#***#.#.#.#
#.#.###.#.#.#####*#*###########*###.#.#.#
#.....#.#...#.#***#***#.#*******#.....#.#
#####.#.#.###.#*#####*#.#*#######.#####.#
#...#.#.#.....#*******#.#*******#.#...#.#
#.#.#.#.###############.#######*#.#.#.#.#
#.#.#.#.#*************..#.#*****#...#.#.#
#.#.###.#*###########*#.#.#*#########.#.#
#.#.....#*****....#***#.#.#***#...#...#.#
#.###########*#####*###.#.###*#.###.###.#
#.#....***#***#*****#...#...#*#...#.#...#
#.#.###*#*#*###*#####.###.#.#*###.#.#.#.#
#.....#*#O#***#*#.....#...#.#***#.#...#.#
#.#####*#####*#*#.#####.#######*#.#####.#
#.#.#***#*****#*#.......#***..#*#...#...#
#.#.#*###*#####*#########*#*###*#.#.#.###
#...#***#***#.#*#***#***#*#*****#.#.#.#.#
###.###*###*#.#*#*#*#*#*#*#######.###.#.#
#.....#*****..#***#***#***#.............#
#########################################